E E E E E E E E E E E E E E E E E E E E E E E E E E E E E E E E
E A A A A A A A A A A A A A A A A A A A A A A A A A A A A A A E
E A A A A A A A A A A A A A A A A A A A A A A A A A A A A A A E
E A A A A A A A A A A A A A A A A A A A A A A A A A A A A A A E
E A A A A A A A A A A A A A A A A A A A A A A A A A A A A A A E
E A A A A A A A A A A A A A A A A A A A A A A A A A A A A A A E
E A A A A A A A A A A A A A A A A A A A A A A A A A A A A A A E
E A A A A A A A A A A A A A A A A A A A A A A A A A A A A A A E
E A A A A A A A A A A A A A A A A A A A A A A A A A A A A A A E
E A A A A A A A A A A A A A A A A A A A A A A A A A A A A A A E
E A A A A A A A A A A A A A A A A A A A A A A A A A A A A A A E
E A A A A A A A A A A A A A A A A A A A A A A A A A A A A A A E
E A A A A A A A A A A A A A A A A A A A A A A A A A A A A A A E
E A A A A A A A A A A A A A A A A A A A A A A A A A A A A A A E
E A A A A A A A A A A A A A A A A A A A A A A A A A A A A A A E
E A A A A A A A A A A A A A A A A A A A A A A A A A A A A A A E
E 0 A 2 A A 3 A A A 4 A A A 1 A A A A A A A A A A A A A A A 5 E
E E E E E E E E E E E E E E E E E E E E E E E E E E E E E E E E